0, 9, 0, 0, 6, 6, 0,
0, 0, 0, 0, 0, 0, 0,
4, 0, 0, 0, 0, 0, 6,
4, 0, 0, 0, 0, 0, 6
0, 0, 0, 0, 0, 0, 0,
0, 6, 4, 0, 0, 8, 0,